%%%%%%
%   .%
%.P..%
%    %
%%%%%%